1111111111111
100P00C000E01
10000C00C0001
1111111111111