1111111111111111111111111
1P000C00000000000000000E1
1001111011111011111011101
1C000000C000C000C000000C1
1010111010111010111011101
1C000C000000C000000C000C1
1011101111011101111011101
1C000000C000000C0000000C1
1001111011111011111011101
1C000000000C00000000000C1
1111111111111111111111111
