1111111111111
100C0000000C1
1000001000001
1P00C0E000C01
1111111111111